 العبادات.

المقصد الرابع: في أحكام الأسرة.

المقصد الخامس: في الحاجات الضرورية.

المقصد السادس: في المعاملات.

المقصد السابع: في الإمامة وشؤون الحكم.

المقصد الثامن: في الرقائق والأخلاق والآداب.

المقصد التاسع: في التاريخ والسيرة والمناقب.

المقصد العاشر: في الفتن.

(1/ 20)


 




وينضوي تحت كل مقصد " كتب " وتحت كل كتاب " فصول " وفي كل فصل " أبواب ".

ثانيًا: تخريج الأحاديث والحكم عليها: ذكرت في آخر كل حديث الحكم عليه صحة وحسنًا وغير ذلك، وأما مرجع هذه الأحكام فهو كالتالي:

- " السنن الأربعة ": الشيخ ناصر الدين الألباني - رحمه الله -.

- " سنن الدارمي ": محققه الأستاذ حسين سليم أسد الداراني.

- " مسند الإمام أحمد ": فضيلة الشيخ شعيب الارناؤوط في طبعة مؤسسة الرسالة.

- " الموطأ ": فضيلة الشيخ عبد القادر الارناؤوط - رحمه الله - في تحقيقه ل ـ " جامع الأصول ".

- " السنن الكبرى " للبيهقي: قال مصنفه: " وعادتي في كتبي المصنفة في الأصول والفروع الاقتصار من الأخبار على ما يصح منها دون ما لا يصح، أو التمييز بين ما يصح منها وما لا يصح ".

وهذا يعني أن ما لم يعلق عليه المصنف فهو من الصحيح أو الْحسن، كما علق الإمام الذهبي على بعض أحاديثه.

- " صحيح ابن خزيمة ": قام محققه الدكتور مُحَمَّد مصطفى الأعظمي بالحكم على الأحاديث، وشاركه في بعضها الشيخ " الألباني ".

- " صحيح ابن حبان ": قام محققه الشيخ شعيب الارناؤوط بتخريج أحاديثه.

(1/ 21)


 




- " المستدرك ": قام الحافظ الذهبي بالتعليق على بعضه أحاديثه.

- " الأحاديث المختارة " للمقدسي: قام محققه الدكتور عبد الْملك بن دهيش بتخريج أحاديثه.

ثالثًا: المصطلحات

الرمز: الكتاب

خ: البخاري

م: مسلم

ق: متفق عليه

خ ـ: معلقات البخاري

د: سنن أبي داود

ت: سنن الترمذي

ن: سنن النسائي

جه: سنن ابن ماجه

مي: سنن الدارمي

حم: الْمسند

ط: الموطأ

مه: ابن خزيمة

حب: ابن حبان

ك: المستدرك

هق: سنن البيهقي

مخ: الأحاديث المختارة

ت: إشارة إلى ذكر بعض التعليقات على بعض الأحاديث

ع: للدلالة على أن الحديث من رواية عبد الله بن الإمام أحمد، أو من وجاداته

(1/ 22)


 




وبعد:

فهذا مَا يَسَّرَ اللهُ تعالى - بعونه - عمله لجمع هذا الكتاب، الذي أرجو أن يكون وافيًا بالغرض الذي قصد إليه، ملبيًا لحاجة كل مسلم فيما يجب عليه من تعرفه على النَّبِيَّ